87
 ###########↓############
 ##                    ##
 ##                    ##
 ##                    ##
 ##                    ##
 ##                    ##
 ##                    ##
 ##                    ##
 ##                    ##
 ##                    ##
 ##                    ##
 ########################