86 4
 ###########↑############
 ##                    ##
 ##   G            G   ##
 ##                    ##
 ##                    ##
 ##                    ##
 ##                    ##
 ##                    ##
 ##                    ##
 ##   G            G   ##
 ##                    ##
 ###########↓############