86 4
 ###########↓############
 ##                    ##
 ##   F            F   ##
 ##                    ##
 ##                    ##
 ##                    ##
 ##                    ##
 ##                    ##
 ##                    ##
 ##   F            F   ##
 ##                    ##
 ###########↑############