86 46 325 8 8 8 8 4
 ###########↓############     ┏     ┓  ┏   ━━━━━━┓           ┏      ━━━━━━━━━━━━━━━━━━━┓
 ##                    ##     ┃     ┃  ┃         ┃           ┃                         ┃
 ##   F            F   ##     ┗━━━━━┛  ┗━━━━━━━━━┛           ┃                         ┃
 ##                    ##                                    ┃                         ┃
 ##                    ##     ┏  ━━━━━━━┓     ┏      ━━━━┓   ┃                         ┃
 ##                    ##     ┃         ┃     ┃          ┃   ┃                         ┃
 ##                    ##     ┗━━━━━━━━━┛     ┃          ┃   ┃                         ┃
 ##                    ##                     ┗━━━━━━━━━━┛   ┃                         ┃
 ##                    ##     ┏     ━━━━━━━┓  ┏   ━━━━━━━┓   ┣━━━━━━━━━━┳━━━━━━━━━━━━━━┫
 ##   F            F   ##     ┃            ┃  ┃          ┃   ┃          ┃              ┃
 ##                    ##     ┗━━━━━━━━━━━━┛  ┃          ┃   ┃          ┃              ┃
 ###########↑############                     ┗━━━━━━━━━━┛   ┗━━━━━━━━━━┻━━━━━━━━━━━━━━┛

┏━━━━━━━━━━━━━━━━━━━━━━━━━━━━━━━━━━━━━━━━━━━━━━━━━━━━━━━━━━━━━━━━━━━━━━━━━━━━━━━━━━━━━━┓
┃                                                                                      ┃
┃                                                                                      ┃
┃                                                                                      ┃
┃                                                                                      ┃
┃                                                                                      ┃
┗━━━━━━━━━━━━━━━━━━━━━━━━━━━━━━━━━━━━━━━━━━━━━━━━━━━━━━━━━━━━━━━━━━━━━━━━━━━━━━━━━━━━━━┛