86 4
 ###########↑############
 ##                    ##
 ##   S            S   ##
 ##                    ##
 ##                    ##
 ##                    ##
 ##                    ##
 ##                    ##
 ##                    ##
 ##   S            S   ##
 ##                    ##
 ###########↓############