GoalCount: 15
SpawnInterval: 1500
BBBBBBBBBBBBBBBBBBBBBBBBBBBBBBBBBBBBBBBBBBBBBBBBBBBBBBBBBBB
B                                                         B
B                                                         B
BBBBBBBBB     BBBBBBBBB             BBBBBBBBB     BBBBBBBBB
BBBBBBBBBBB   BBBBBBBBB   BBBBBBBBBBBBBBBBBBB  BBBBBBBBBBBB
BBBBBBBBB     BBBBBBBBB             BBBBBBBBB     BBBBBBBBB
BBBBBBBBB  BBBBBBBBBBBBBBBBBBBBBB   BBBBBBBBBBBB  BBBBBBBBB
BBBBBBBBB     BBBBBBBBB             BBBBBBBBB     BBBBBBBBB
BBBBBBBBBBBB  BBBBBBBBB   BBBBBBBBBBBBBBBBBBB  BBBBBBBBBBBB
BBBBBBBBB     BBBBBBBBB             BBBBBBBBB     BBBBBBBBB
BBBBBBBBB  BBBBBBBBBBBBBBBBBBBBBB   BBBBBBBBBBBB  BBBBBBBBB
BBBBBBBBB     BBBBBBBBB             BBBBBBBBB     BBBBBBBBB
BBBBBBBBBBBB  BBBBBBBBB   BBBBBBBBBBBBBBBBBBB  BBBBBBBBBBBB
BBBBBBBBB     BBBBBBBBB             BBBBBBBBB     BBBBBBBBB
BBBBBBBBB  BBBBBBBBBBBBBBBBBBBBBB   BBBBBBBBBBBB  BBBBBBBBB
BBBBBBBBB     BBBBBBBBB             BBBBBBBBB     BBBBBBBBB
B                                                         B
B       P                                                 B
BBBBBBBBBBBBBBBBBBBBBBBBBBBBBBBBBBBBBBBBBBBBBBBBBBBBBBBBBBB