GoalCount: 1
SpawnInterval: 1800
BBBBBBBBBBBBBBBBBBBBBBBBBBBBBBBBBBBBBBBBBBBBBBBBBBBBBBBBBBB
B        BBB               BBB                BBB         B
B        BBB               BBB                BBB         B
B        BBB               BBB                BBB         B
B        BBB               BBB                BBB         B
B       BBBBB            BBBBBBB             BBBBB        B
B                      P BBBBBBB                          B
B                                                         B
B                                                         B
B                                                         B
B                                                         B
B                        BBBBBBB                          B
B                        BBBBBBB                          B
B       BBBBB              BBB               BBBBB        B
B        BBB               BBB                BBB         B
B        BBB               BBB                BBB         B
B        BBB               BBB                BBB         B
B        BBB               BBB                BBB         B
BBBBBBBBBBBBBBBBBBBBBBBBBBBBBBBBBBBBBBBBBBBBBBBBBBBBBBBBBBB