5
BBBBBBBBBBBBBBBBBBBBBBBBBBBBBBBBBBBBBBBBBBBBBBBBBBBBBBBBBBB
B                                                         B
B                                                         B
B                                                         B
B                                                         B
B             P                                           B
B                                                         B
B                                                         B
B                                                         B
B                                                         B
B                                                         B
B                                                         B
B                                                         B
B                                                         B
B                                                         B
B                                                         B
B                                                         B
B                                                         B
BBBBBBBBBBBBBBBBBBBBBBBBBBBBBBBBBBBBBBBBBBBBBBBBBBBBBBBBBBB