GoalCount: 25
SpawnInterval: 500
BBBBBBBBBBBBBBBBBBBBBBBBBBBBBBBBBBBBBBBB
BBBBBBBB  BBBBBBB   BBBBBBBBBBBBBBBBBBBB
BBBBBBBB   BBBB    BBBBBBBBBBBBBBBBBBBBB
BBBBBBB   B         BBBBBBBBBBBBBBBBBBBB
BBBBBBB              BBBBBBBBBBBBBBBBBBB
BBBBBBB              BBBBBBBBBBBBBBBBBBB
BBBBBBB       B      BBBBBBBBBBBBBBBBBBB
BBBBBB          P    BBBBBBBBBBBBBBBBBBB
BBBBBB B             BBBBBBBBBBBBBBBBBBB
BBBBBB    B         BBBBBBBBBBBBBBBBBBBB
BBBBBB            B BBBBBBBBBBBBBBBBBBBB
BBBBBB        B       BBBBBBBBBBBBBBBBBB
BBBBBBB      BB  BB B  BBBBBBBBBBBBBBBBB
BBBBBBBBB   BBBB          BBBBBBBBBBBBBB
BBBBBBBBBBBBBB       B             BBBBB
BBBBBBBBBBBBB               B     BBBBBB
BBBBBB   B B       BB        B B BBBBBBB
BBBBBB B          B       B   B  BBBBBBB
BBBBB    B B   B                 BBBBBBB
BBBBBBB                B       BBBBBBBBB
BBBBBBB    B                 BBBBBBBBBBB
BBBBBBBBB      B         B   BBBBBBBBBBB
BBBBBBBBBB B    B    B     BBBBBBBBBBBBB
BBBBBBBBBBBBB   B        BBBBBBBBBBBBBBB
BBBBBBBBBBBBBBBBBBBBBBBBBBBBBBBBBBBBBBBB
