GoalCount: 5
SpawnInterval: 1500
BBBBBBBBBBBBBBBBBBBBBBBBBBBBBBBBBBBBBBBBBBBBBBBBBBBBBBBBBBB
B                                                         B
B                                                         B
BBBBBBBBB       BBBBBBBBB         BBBBBBBBB       BBBBBBBBB
B                                                         B
B                                                         B
BBBBBBBBB       BBBBBBBBB         BBBBBBBBB       BBBBBBBBB
B                           P                             B
B                                                         B
BBBBBBBBB       BBBBBBBBB         BBBBBBBBB       BBBBBBBBB
B                                                         B
B                                                         B
BBBBBBBBB       BBBBBBBBB         BBBBBBBBB       BBBBBBBBB
B                                                         B
B                                                         B
BBBBBBBBB       BBBBBBBBB         BBBBBBBBB       BBBBBBBBB
B                                                         B
B                                                         B
BBBBBBBBBBBBBBBBBBBBBBBBBBBBBBBBBBBBBBBBBBBBBBBBBBBBBBBBBBB