GoalCount: 5
SpawnInterval: 1500

BBBBBBBBBBBBBBBBBBBBBBBBBBBBBBBBBBBBBBBBBBBBBBBBBBBBBBBBBBB
B                                                         B
B                                                         B
BBBBBBBBBBBBBBBBBBBBBBBBB        BBBBBBBBBBBBBBBBBBBBBBBBBB
B                                                         B
B                                                         B
BBBBBBBBBBBBBBBBBBBBBBBBB        BBBBBBBBBBBBBBBBBBBBBBBBBB
B                           P                             B
B                                                         B
BBBBBBBBBBBBBBBBBBBBBBBBB        BBBBBBBBBBBBBBBBBBBBBBBBBB
B                                                         B
B                                                         B
BBBBBBBBBBBBBBBBBBBBBBBBB        BBBBBBBBBBBBBBBBBBBBBBBBBB
B                                                         B
B                                                         B
BBBBBBBBBBBBBBBBBBBBBBBBB        BBBBBBBBBBBBBBBBBBBBBBBBBB
B                                                         B
B                                                         B
BBBBBBBBBBBBBBBBBBBBBBBBBBBBBBBBBBBBBBBBBBBBBBBBBBBBBBBBBBB