##########
#8#k b####
# bMB X ##
#b b bb O#
# b b bb #
## b b ###
##########
38 0 13 2 22 true