#########
##    ###
##e#MM  #
# M##BBb#
#  ## M #
#8 ## e #
#####O e#
#########
45 3 3 6 23 false