#########
##### 8##
##  e  ##
## e e###
#  ######
# b  b ##
# b b  O#
#########
46 3 4 0 24 false