###########
#### O ####
####bXb####
##b#b  # ##
#b  bbb  k#
# bbb  bb #
##8 b  b ##
###########
52 0 15 0 33 true