########
#### O##
### Xb #
#8#M b #
# # M M#
#e#bbbb#
#M M  M#
######k#
########
44 1 6 6 25 true
