##########
####  O ##
#######X##
### MM  8#
###M#M#  #
###  eMM##
#k#M#M# ##
#     e ##
##########
59 2 0 8 31 true