########
####O ##
#### X #
# k#bbb#
#eb eb #
# #e  8#
#M##_###
#_M_M###
########
45 3 5 6 33 true 