0 0 0 0 0 0 12 12 4 0 0 0 



          #######22##########          
          #ii          &/-\&#             
          #ii          |ggg|#             
          #            |ggg|#             
          #            |ggg|#             
          #hhhhhh      |ggg|#          
          #hhhhhh      &\-/&#          
          ###################          




                                            
                                            
                                            