48 2 8 0 4 12 4 0 2 2 0



          #######22##########          
          #@@          &/-\&#             
          #@@          |   |#             
          #            |   |#             
          #            |   |#             
          #======      |   |#          
          #======      &\-/&#          
          ###################          




                                            
                                            
                                            